Andrei Kirilenko	MIN 
DeAndre Liggins	OKC 
Jared Jeffries	POR 
Boris Diaw	SAS 
Alec Burks	UTA 
Harrison Barnes	GSW 
Evan Fournier	DEN 
Kevin Martin	OKC 
Wilson Chandler	DEN 
Ramon Sessions	CHA 
Tyrus Thomas	CHA 
Beno Udrih	TOT 
Klay Thompson	GSW 
Jan Vesely	WAS 
Jerryd Bayless	MEM 
Ryan Hollins	LAC 
Ronny Turiaf	LAC 
Solomon Jones	NYK 
Rajon Rondo	BOS 
Jason Maxiell	DET 
Marvin Williams	UTA 
Sasha Pavlovic	POR 
Kyrie Irving	CLE 
Jae Crowder	DAL 
Chris Wright	DAL 
Terrence Jones	HOU 
Antawn Jamison	LAL 
Josh Howard	MIN 
Tony Parker	SAS 
Kevin Durant	OKC 
Gerald Henderson	CHA 
Nick Young	PHI 
Carmelo Anthony	NYK 
Darrell Arthur	MEM 
Julyan Stone	DEN 
Larry Sanders	MIL 
Josh Harrellson	MIA 
Terrence Ross	TOR 
Shane Battier	MIA 
Chris Copeland	NYK 
Reggie Evans	BRK 
Stephen Curry	GSW 
JaVale McGee	DEN 
Keyon Dooling	MEM 
Louis Williams	ATL 
Victor Claver	POR 
Greivis Vasquez	NOH 
Wayne Ellington	TOT 
Doron Lamb	TOT 
Marquis Daniels	MIL 
Ekpe Udoh	MIL 
Brandon Bass	BOS 
Tiago Splitter	SAS 
Landry Fields	TOR 
Jameer Nelson	ORL 
O.J. Mayo	DAL 
Will Conroy	MIN 
Kendall Marshall	PHO 
Rudy Gay	TOT 
Carlos Boozer	CHI 
Daniel Orton	OKC 
Manu Ginobili	SAS 
E'Twaun Moore	ORL 
Aron Baynes	SAS 
Sebastian Telfair	TOT 
Tobias Harris	TOT 
George Hill	IND 
Brian Roberts	NOH 
Kenneth Faried	DEN 
Vince Carter	DAL 
Steve Nash	LAL 
Jeremy Tyler	TOT 
Mickael Pietrus	TOR 
Anthony Randolph	DEN 
Jordan Crawford	TOT 
Shelvin Mack	TOT 
Monta Ellis	MIL 
Joe Johnson	BRK 
Kenyon Martin	NYK 
Rodrigue Beaubois	DAL 
Chris Johnson	MIN 
D.J. White	BOS 
Darius Morris	LAL 
Jordan Hill	LAL 
Earl Watson	UTA 
Michael Beasley	PHO 
Vladimir Radmanovic	CHI 
Jeff Adrien	CHA 
Rashard Lewis	MIA 
Shannon Brown	PHO 
Jason Kidd	NYK 
Tim Ohlbrecht	HOU 
Kevin Garnett	BOS 
Anthony Morrow	TOT 
Wesley Johnson	PHO 
Jimmer Fredette	SAC 
Cartier Martin	WAS 
Terrel Harris	TOT 
Dominic McGuire	TOT 
Trevor Booker	WAS 
Jared Cunningham	DAL 
Kobe Bryant	LAL 
Patrick Patterson	TOT 
Meyers Leonard	POR 
Tim Duncan	SAS 
Robin Lopez	NOH 
Kevin Jones	CLE 
Dion Waiters	CLE 
Khris Middleton	DET 
Daequan Cook	TOT 
Gustavo Ayon	TOT 
Chris Singleton	WAS 
Perry Jones	OKC 
Bradley Beal	WAS 
Tristan Thompson	CLE 
Charles Jenkins	TOT 
Nolan Smith	POR 
Ricky Rubio	MIN 
DeSagana Diop	CHA 
Omer Asik	HOU 
Martell Webster	WAS 
Darko Milicic	BOS 
Pablo Prigioni	NYK 
Patrick Mills	SAS 
Mike Miller	MIA 
Ishmael Smith	TOT 
Andre Miller	DEN 
Marcus Thornton	SAC 
DaJuan Summers	LAC 
John Jenkins	ATL 
Dorell Wright	PHI 
Chase Budinger	MIN 
Darius Miller	NOH 
Austin Rivers	NOH 
Quincy Pondexter	MEM 
Norris Cole	MIA 
Chris Quinn	CLE 
Aaron Brooks	TOT 
Mickael Gelabale	MIN 
Earl Clark	LAL 
Markieff Morris	PHO 
Donatas Motiejunas	HOU 
LeBron James	MIA 
Timofey Mozgov	DEN 
Joel Przybilla	MIL 
Andris Biedrins	GSW 
Andrew Goudelock	LAL 
Jonas Valanciunas	TOR 
Luol Deng	CHI 
Kris Humphries	BRK 
Brandon Roy	MIN 
Jordan Hamilton	DEN 
Maurice Harkless	ORL 
Josh Smith	ATL 
John Lucas	TOR 
Josh Selby	MEM 
Michael Kidd-Gilchrist	CHA 
Marco Belinelli	CHI 
John Wall	WAS 
Tyler Zeller	CLE 
Justin Dentmon	DAL 
Spencer Hawes	PHI 
C.J. Miles	CLE 
Drew Gooden	MIL 
Malcolm Thomas	TOT 
DeQuan Jones	ORL 
Paul Pierce	BOS 
Jamal Crawford	LAC 
Tyler Hansbrough	IND 
J.J. Hickson	POR 
Orlando Johnson	IND 
Miles Plumlee	IND 
Amar'e Stoudemire	NYK 
Matt Barnes	LAC 
John Salmons	SAC 
Andrea Bargnani	TOR 
Gerald Wallace	BRK 
Nate Robinson	CHI 
Shawn Marion	DAL 
Al-Farouq Aminu	NOH 
Kyle O'Quinn	ORL 
Kyle Lowry	TOR 
Scott Machado	HOU 
Derrick Williams	MIN 
DeMarre Carroll	UTA 
Robert Sacre	LAL 
Al Horford	ATL 
Mike Scott	ATL 
Jeff Teague	ATL 
Jonas Jerebko	DET 
Luc Mbah a Moute	MIL 
Kosta Koufos	DEN 
Marcus Morris	TOT 
Brandon Jennings	MIL 
Reggie Jackson	OKC 
Andray Blatche	BRK 
Ryan Anderson	NOH 
Grant Hill	LAC 
Anthony Davis	NOH 
Brandon Knight	DET 
Nene Hilario	WAS 
David Lee	GSW 
Josh McRoberts	TOT 
James Jones	MIA 
Randy Foye	UTA 
Charlie Villanueva	DET 
Lance Thomas	NOH 
Nikola Pekovic	MIN 
Kemba Walker	CHA 
Will Barton	POR 
Deron Williams	BRK 
Metta World Peace	LAL 
DeMar DeRozan	TOR 
Dante Cunningham	MIN 
Damian Lillard	POR 
Carlos Delfino	HOU 
C.J. Watson	BRK 
James Johnson	SAC 
David West	IND 
Ben Hansbrough	IND 
Caron Butler	LAC 
Enes Kanter	UTA 
Mirza Teletovic	BRK 
Rodney Stuckey	DET 
Jeremy Evans	UTA 
Luke Ridnour	MIN 
Tyreke Evans	SAC 
Corey Maggette	DET 
Steve Blake	LAL 
Andre Iguodala	DEN 
Tyler Honeycutt	SAC 
Arron Afflalo	ORL 
A.J. Price	WAS 
Alonzo Gee	CLE 
Chris Duhon	LAL 
Shavlik Randolph	BOS 
Dahntay Jones	TOT 
John Henson	MIL 
Kim English	DET 
Cory Higgins	CHA 
Chris Kaman	DAL 
Raymond Felton	NYK 
Chris Paul	LAC 
Kyle Singler	DET 
Daniel Gibson	CLE 
Kevin Murphy	UTA 
Lamar Odom	LAC 
Josh Akognon	DAL 
Derek Fisher	TOT 
Anderson Varejao	CLE 
Mike Dunleavy	MIL 
Gerald Green	IND 
Damien Wilkins	PHI 
Jason Smith	NOH 
Lavoy Allen	PHI 
Brandan Wright	DAL 
Quincy Acy	TOR 
Chauncey Billups	LAC 
Eddy Curry	DAL 
Linas Kleiza	TOR 
Jimmy Butler	CHI 
Iman Shumpert	NYK 
Thomas Robinson	TOT 
Maalik Wayns	TOT 
Jason Thompson	SAC 
Blake Griffin	LAC 
Austin Daye	TOT 
Jarrett Jack	GSW 
Joel Anthony	MIA 
Patrick Beverley	HOU 
Terrence Williams	BOS 
Jared Sullinger	BOS 
Tony Allen	MEM 
Jodie Meeks	LAL 
Matt Carroll	CHA 
Keith Bogans	BRK 
Thabo Sefolosha	OKC 
Lance Stephenson	IND 
Kent Bazemore	GSW 
Ed Davis	TOT 
Serge Ibaka	OKC 
Jason Terry	BOS 
Nikola Vucevic	ORL 
Kyle Korver	ATL 
Jeremy Pargo	TOT 
Arnett Moultrie	PHI 
Chuck Hayes	SAC 
Evan Turner	PHI 
Andre Drummond	DET 
Hamed Haddadi	TOT 
Jannero Pargo	TOT 
Marquis Teague	CHI 
Anthony Tolliver	ATL 
Steve Novak	NYK 
Derrick Favors	UTA 
Andrew Bogut	GSW 
Travis Outlaw	SAC 
Al Harrington	ORL 
Ivan Johnson	ATL 
Hedo Turkoglu	ORL 
Draymond Green	GSW 
Jamaal Tinsley	UTA 
Jason Richardson	PHI 
Zach Randolph	MEM 
Henry Sims	NOH 
Quincy Miller	DEN 
Malcolm Lee	MIN 
Danny Green	SAS 
Greg Monroe	DET 
Jerry Stackhouse	BRK 
Greg Stiemsma	MIN 
Matt Bonner	SAS 
DeShawn Stevenson	ATL 
Chandler Parsons	HOU 
Kirk Hinrich	CHI 
Al Jefferson	UTA 
Damion James	BRK 
Byron Mullens	CHA 
Nazr Mohammed	CHI 
Andrew Nicholson	ORL 
Jared Dudley	PHO 
Courtney Lee	BOS 
J.J. Redick	TOT 
Tony Wroten	MEM 
Jeff Taylor	CHA 
Stephen Jackson	SAS 
Richard Hamilton	CHI 
LaMarcus Aldridge	POR 
Kris Joseph	TOT 
Marreese Speights	TOT 
Dominique Jones	DAL 
Juwan Howard	MIA 
Jermaine O'Neal	PHO 
Dwyane Wade	MIA 
Bismack Biyombo	CHA 
Leandro Barbosa	BOS 
Amir Johnson	TOR 
Luke Walton	CLE 
Gary Neal	SAS 
Jose Calderon	TOT 
Danilo Gallinari	DEN 
Glen Davis	ORL 
Ian Mahinmi	IND 
James Harden	HOU 
Darren Collison	DAL 
Luke Babbitt	POR 
Avery Bradley	BOS 
Jeremy Lamb	OKC 
Devin Harris	ATL 
Justin Holiday	PHI 
Will Bynum	DET 
Mario Chalmers	MIA 
Dexter Pittman	TOT 
Richard Jefferson	GSW 
Jeff Ayres	IND 
Jarvis Varnado	TOT 
Darius Johnson-Odom	LAL 
Marc Gasol	MEM 
Brendan Haywood	CHA 
DeAndre Jordan	LAC 
Elton Brand	DAL 
Eric Bledsoe	LAC 
Xavier Henry	NOH 
Eric Maynor	TOT 
Festus Ezeli	GSW 
Garrett Temple	WAS 
Udonis Haslem	MIA 
Royal Ivey	PHI 
DeMarcus Cousins	SAC 
Tyshawn Taylor	BRK 
Omri Casspi	CLE 
Alexey Shved	MIN 
Marcin Gortat	PHO 
Jon Leuer	TOT 
Kawhi Leonard	SAS 
Viacheslav Kravtsov	DET 
Jose Barea	MIN 
Alan Anderson	TOR 
J.R. Smith	NYK 
Taj Gibson	CHI 
Fab Melo	BOS 
Reggie Williams	CHA 
Goran Dragic	PHO 
James White	NYK 
Tyson Chandler	NYK 
Paul George	IND 
Quentin Richardson	NYK 
Kendrick Perkins	OKC 
Louis Amundson	TOT 
Nando De Colo	SAS 
Ben Gordon	CHA 
Zaza Pachulia	ATL 
Luis Scola	PHO 
Lazar Hayward	MIN 
Jeff Green	BOS 
Isaiah Thomas	SAC 
Troy Murphy	DAL 
Chris Bosh	MIA 
Dwight Howard	LAL 
James Anderson	TOT 
Marcus Camby	NYK 
D.J. Augustin	IND 
Joel Freeland	POR 
Luke Zeller	PHO 
Toney Douglas	TOT 
Willie Green	LAC 
Dirk Nowitzki	DAL 
Trevor Ariza	WAS 
Brook Lopez	BRK 
Ronnie Price	POR 
Cory Joseph	SAS 
Paul Millsap	UTA 
Cole Aldrich	TOT 
Johan Petro	ATL 
Mike Conley	MEM 
Mike James	DAL 
Hasheem Thabeet	OKC 
Eric Gordon	NOH 
Devin Ebanks	LAL 
Joakim Noah	CHI 
Hakim Warrick	TOT 
Bernard James	DAL 
Danny Granger	IND 
Ronnie Brewer	TOT 
Samuel Dalembert	MIL 
Nicolas Batum	POR 
Kwame Brown	PHI 
Wesley Matthews	POR 
Brandon Rush	GSW 
Carl Landry	GSW 
Jason Collins	TOT 
Chris Douglas-Roberts	DAL 
Shaun Livingston	TOT 
Emeka Okafor	WAS 
Greg Smith	HOU 
Tayshaun Prince	TOT 
Samardo Samuels	CLE 
Russell Westbrook	OKC 
Rasheed Wallace	NYK 
Francisco Garcia	TOT 
Ersan Ilyasova	MIL 
Ray Allen	MIA 
P.J. Tucker	PHO 
Sam Young	IND 
Pau Gasol	LAL 
Thaddeus Young	PHI 
Kurt Thomas	NYK 
Ty Lawson	DEN 
Jeremy Lin	HOU 
Tornike Shengelia	BRK 
Nick Collison	OKC 
Chris Wilcox	BOS 
Donald Sloan	TOT 
Jrue Holiday	PHI 
Mo Williams	UTA 
Chris Andersen	MIA 
Diante Garrett	PHO 
Corey Brewer	DEN 
Roger Mason	NOH 
Earl Barron	TOT 
Josh Childress	BRK 
Roy Hibbert	IND 
Kevin Love	MIN 
DeJuan Blair	SAS 
Kevin Seraphin	WAS 
MarShon Brooks	BRK 
Aaron Gray	TOR 
Gordon Hayward	UTA 
